W W W W W W W W W W W W W W W W W W W W W W W W W W W W W W W W W W W W W W W W W W W W W W W W W W W W W W
W W W W W W W W W G W W W W W W W W W W W W W W W W W W W W W W W W W W W W W W W W W W W W W W W W W W W W
W W W W W W G G G G W W W W W W W W W W W W W W W W W W W W W W W W W W W W W W W W W W W W W W W W W W W W
W W W W G G S G G G G W G W W W W W W W W W W W W W W W W W W W W W W W W W W W W W W W W W W W W W W W W W
W W W W G G G G G G G G G W G G W W W W W W W W W W W W W W W W W W W W W W W W W W W W W W W W W W W W W W
W W W W W G G B G G G G G G G G W W W W W W W W W W W W W W W W W W W W W W W W W W W W W W W W W W W W W W
W W W W W G G G G G G G G G G G G G W W W W W W W W W W W W W W W W W W W W W W W W W W W W W W W W W W W W
W W W G G G G G W G G G G G G G G G G G G W W W W W W W W W W W W W W W W W W W W W W W W W W W W W W W W W
W W W G G G G W W W G G G G G G G G G G G G G G G W W W W W W W W W W W W W W W W W W W W W W W W W W W W W
W W W W W W W W W W W G G G G G W G G G G G G G W W W W W W W W W W W W W W W W W W W W W W W W W W W W W W
W W W W W W W W W W W W W W W G W W W B G G G W W W W W W W W W W W W W W W W W W W W W W W W W W W W W W W
W W W W W W W W W W W W W W W W W W W G G G W W W W W W W W W W W W W W W W W W W W W W W W W W W W W W W W
W W W W W W W W W W W W W W W W W W W W W W W W W W G W W W W W W W W W W W W W W W W W W W W W W W W W W W
W W W W W W W W W W W W G G W W W W W W W W W W G G G G W W W W W W W W W W W W W W W W W W W W W W W W W W
W W W W W W W W W W G B G G G W W W W W W W W W W G W G W W W W W W W W W W W W W W W W W W W W W W W W W W
W W W W W W W W W W G G G G W W W W W W W W W W W W W W W W W W W W W W W W W W W W W W W W W W W W W W W W
W W W W W W W W W W W G W W W W W W W W W W W W W W W W W W W W W W W W W W W W W W W W W W W W W W W W W W
W W W W W W W W W W W W W W W W W W W W W W W W W W W W W W W W W W W W W W W W W W W W W W W W W W W W W W
W W W W W W W W W W W W W W W W W W W W W W W W W W W W W W W W W W W W W W W W W W W W W W W W W W W W W W
W W W W W W W W W W W W W W W W W W W W W W W W W W W W W W W W W W W W W W W W W W W W W W W W W W W W W W
W W W W W W W W W W W W W W W W W W W W W W W W W W W W W W W W W W W W W W W W W W W W W W W W W W W W W W
W W W W W W W W W W W W W W W W W W W W W W W W W W W W W W W W W W W W W W W W W W W W W W W W W W W W W W
W W W W W W W W W W W W W W W W W W W W W W W W W W W W W W W W W W W W W W W W W W W W W W W W W W W W W W
W W W W W W W W W W W W W W W W W W W W W W W W W W W W W W W W W W W W W W W W W W W W W W W W W W W W W W
W W W W W W W W W W W W W W W W W W W W W W W W W W W W W W W W W W W W W W W W W W W W W W W W W W W W W W
W W W W W W W W W W W W W W W W W W W W W W W W W W W W W W W W W W W W W W W W W W W W W W W W W W W W W W
